75 16 75 16 16 79 16 16 16 16 16 16 103 45 16 16 16 16 44 16 16 102 74 74 16 16 75 16 16 74 16 46 16 74 16 46 16 44 16 16 16 16 49 16 16 79 16 48 16 16 16 74 103 16 16 16 16 16 16 49
16 16 16 16 16 16 44 48 46 16 75 44 77 103 46 16 16 75 16 16 16 16 102 16 16 16 16 16 75 16 16 16 46 75 49 16 16 155 155 155 155 155 458 16 44 47 16 16 72 16 16 46 16 77 45 16 75 16 16 49
77 75 16 44 16 16 16 44 16 16 16 16 79 16 16 16 16 16 16 16 45 16 46 16 16 16 16 16 47 102 75 16 16 458 155 155 155 155 155 155 155 461 155 155 155 461 155 75 74 102 72 16 16 16 16 16 16 16 16 16
16 16 16 16 103 16 16 46 44 49 72 75 16 16 16 16 16 16 16 49 16 16 77 16 79 16 48 103 16 16 155 155 155 155 155 155 155 155 155 155 155 460 460 155 155 458 458 155 155 16 16 16 16 16 16 103 16 16 16 44
16 16 103 16 49 16 16 46 16 75 16 72 49 16 16 16 72 77 16 77 103 49 16 49 16 16 16 16 102 155 458 460 155 155 155 155 155 155 155 460 155 155 155 155 155 459 155 155 460 155 155 16 16 16 49 46 16 79 48 74
77 16 16 46 16 16 77 16 16 102 102 44 16 44 16 46 47 16 44 79 44 16 16 16 16 16 16 49 16 461 155 155 155 155 155 155 155 155 155 155 155 155 155 155 461 155 155 155 460 155 155 155 48 16 72 48 16 75 45 16
46 103 45 75 16 16 16 72 16 16 75 16 16 16 16 16 16 16 102 103 16 16 102 103 46 72 16 16 155 461 155 155 155 155 460 155 155 155 155 155 155 155 155 155 155 155 155 155 460 155 155 155 155 49 77 16 16 16 16 16
16 16 74 16 16 75 16 16 49 16 16 79 16 48 16 103 77 16 47 16 16 49 16 45 16 16 16 16 155 155 460 155 155 459 155 155 155 155 155 155 459 155 155 155 155 155 155 460 155 155 155 155 460 461 77 72 16 16 16 16
45 16 44 16 16 16 16 16 46 16 16 16 74 45 44 103 16 75 16 16 16 16 16 16 16 16 16 155 459 155 155 155 155 155 155 155 155 155 155 461 155 155 155 458 155 155 155 155 155 155 155 155 155 155 155 16 16 16 16 16
16 16 74 77 79 16 16 16 16 44 46 79 48 103 75 16 16 44 46 16 16 16 16 16 16 74 45 155 155 460 460 155 155 155 155 155 155 155 155 155 155 155 459 155 155 155 155 155 155 155 155 155 155 155 155 16 16 16 16 16
74 49 16 16 16 16 16 16 16 102 16 16 16 77 47 48 16 16 77 16 16 16 16 16 16 16 16 155 459 155 155 155 155 155 155 155 155 459 155 155 16 16 155 155 460 155 155 155 155 155 461 459 155 155 459 102 16 16 16 102
16 16 16 16 16 16 16 47 16 16 16 44 47 16 197 16 48 45 49 16 79 103 77 16 102 48 103 155 155 155 155 155 155 155 155 155 155 458 16 49 103 16 44 16 155 458 155 155 155 155 155 155 155 155 155 16 103 16 16 102
79 45 16 47 103 47 16 16 16 79 16 16 16 226 198 199 16 103 16 77 16 46 16 46 16 16 16 155 155 155 155 155 155 155 155 155 155 77 16 45 189 189 16 16 16 155 155 155 155 155 461 461 155 155 155 16 75 16 48 16
16 16 77 16 16 16 16 75 45 16 47 16 16 189 89 197 16 16 44 16 49 16 45 74 16 48 16 16 155 155 155 155 155 155 155 155 459 16 16 189 226 189 198 16 155 155 155 155 155 155 155 155 460 155 16 75 46 49 16 16
16 16 16 16 16 16 16 16 16 16 16 49 16 16 227 189 16 48 102 16 44 16 16 16 16 16 16 103 461 155 155 155 458 155 155 155 155 16 16 189 189 189 189 16 155 155 155 155 155 155 155 155 155 155 44 45 16 16 16 16
16 46 16 16 16 16 16 49 48 74 16 102 16 104 189 74 16 74 44 75 79 72 16 16 44 16 16 16 155 155 155 155 155 459 155 461 461 461 77 75 197 189 72 102 155 155 155 155 155 155 155 155 155 155 16 16 16 16 49 16
16 16 16 16 16 46 16 79 16 46 16 16 44 104 189 78 16 16 16 45 16 102 103 16 16 16 46 16 103 155 459 155 155 155 155 155 155 155 155 104 189 189 78 459 155 155 460 461 155 461 155 155 459 155 16 16 16 16 44 49
16 16 16 49 77 16 16 16 16 16 16 16 16 44 189 44 75 16 49 72 16 16 79 16 16 44 16 79 75 155 458 459 459 155 155 155 155 155 155 104 423 189 78 459 155 155 458 458 155 155 155 155 155 16 16 16 16 16 47 75
16 16 49 49 16 16 74 16 103 16 16 103 75 189 189 189 78 16 16 16 16 16 74 16 16 103 16 16 47 45 155 155 155 155 155 155 155 459 155 104 189 189 78 155 155 155 461 155 155 155 155 155 155 45 72 103 16 103 45 16
16 46 16 16 79 74 49 49 16 16 16 16 16 104 189 189 78 77 16 49 16 16 16 16 75 16 16 79 16 16 79 155 155 155 155 155 155 155 155 104 199 481 78 155 155 155 155 155 155 461 155 155 103 46 16 16 75 16 16 44
47 16 77 16 16 16 49 44 16 16 72 46 16 104 199 189 78 16 45 79 16 16 16 16 49 48 16 77 48 77 16 103 155 155 155 155 459 459 460 104 189 189 78 155 155 155 155 155 155 155 155 16 16 102 46 16 16 16 16 16
16 16 16 74 16 16 16 75 47 16 16 16 16 104 189 189 78 16 45 16 16 44 16 103 16 77 16 48 16 102 77 16 16 72 155 155 155 155 155 104 227 189 78 458 155 155 155 461 155 458 77 16 16 45 16 16 47 16 16 16
16 16 16 16 16 74 16 16 74 16 79 16 16 104 189 189 78 16 16 16 48 16 16 48 74 16 16 16 47 48 74 16 45 16 79 74 155 459 155 104 189 189 78 155 155 155 155 16 16 16 16 49 16 16 16 16 16 102 16 16
79 74 16 16 16 16 46 79 45 49 77 16 426 189 189 189 78 49 79 16 16 16 16 16 16 16 79 44 16 16 16 16 16 16 16 16 16 79 16 16 189 189 78 16 16 16 46 16 16 16 16 16 16 16 79 16 16 48 16 16
16 16 16 72 16 16 16 16 16 16 16 47 426 189 227 189 186 16 16 16 16 16 16 16 102 16 16 16 72 45 16 16 16 16 77 74 16 16 104 189 189 189 16 16 16 45 49 16 16 16 16 102 16 77 103 16 16 16 16 16
16 72 16 16 16 16 16 16 16 74 16 16 426 189 197 189 186 16 16 102 16 16 16 16 16 16 16 16 16 46 79 16 46 16 102 72 47 16 104 198 189 189 189 16 49 16 16 72 46 16 16 16 16 16 16 16 75 16 102 103
16 77 16 16 16 16 16 16 16 74 16 16 426 189 189 189 186 16 75 48 16 16 16 46 16 16 16 72 16 44 16 47 72 102 16 16 16 16 104 189 189 189 189 16 47 103 16 49 48 102 16 16 16 16 72 48 16 44 75 16
16 16 16 47 16 16 16 16 16 45 16 16 16 16 189 189 16 158 158 158 16 47 16 45 16 16 75 16 16 16 158 158 16 197 198 75 158 158 16 189 189 189 189 198 158 158 158 158 158 16 16 16 72 16 16 16 44 16 16 49
72 16 16 16 79 16 16 16 77 48 74 16 16 49 189 189 189 226 197 189 158 158 158 158 158 158 158 158 158 72 189 189 481 226 227 189 189 189 189 189 189 197 226 189 189 189 189 189 189 16 158 158 158 77 16 16 72 16 16 16
16 72 16 16 16 44 44 16 16 16 16 45 16 16 16 189 198 189 189 189 189 198 226 189 189 189 189 189 189 189 199 189 189 189 189 189 189 189 189 189 189 189 198 189 189 189 189 227 189 189 189 189 227 78 16 16 79 16 77 103
16 44 48 45 72 16 103 102 16 16 72 79 16 79 16 188 188 188 188 189 189 189 199 189 189 189 189 189 189 189 189 189 189 189 199 189 189 189 48 76 76 72 189 189 189 227 189 189 189 189 189 189 16 16 16 16 16 16 16 16
16 16 49 16 44 16 16 16 16 16 103 16 16 79 46 16 16 16 16 44 16 189 189 189 189 189 198 199 226 197 198 78 76 76 76 76 76 76 48 158 16 16 76 76 76 76 76 76 76 76 76 76 16 16 49 16 16 44 16 16
77 16 16 72 16 16 77 49 44 16 16 16 47 16 102 16 16 16 102 16 48 188 188 188 188 188 188 188 189 226 227 78 16 103 16 16 79 45 158 449 103 72 16 419 158 16 16 72 16 45 44 16 16 77 16 44 16 16 45 16
102 16 16 16 16 79 102 16 16 16 48 49 16 16 16 16 16 16 45 16 16 16 16 44 16 16 16 104 189 189 189 78 16 16 46 16 16 158 504 505 448 45 449 507 477 158 16 16 16 79 16 46 46 16 75 16 16 16 16 79
16 16 16 75 16 16 16 16 103 72 79 16 16 16 16 103 103 45 16 16 16 16 16 16 16 16 16 16 189 189 189 78 74 45 16 16 158 449 478 507 504 16 448 504 476 475 78 48 72 79 16 16 16 47 16 47 79 16 16 16
77 16 102 16 16 16 46 44 16 16 16 16 16 45 16 103 46 47 16 16 45 44 16 44 75 16 104 189 189 189 189 78 16 45 16 104 477 478 505 507 45 44 449 504 418 447 78 16 16 16 48 49 16 72 16 16 77 16 77 44
16 74 49 16 45 102 16 16 16 16 16 16 16 16 16 16 16 16 16 16 16 16 16 74 16 16 104 197 198 189 189 103 16 16 16 104 507 506 447 447 16 16 16 478 475 475 418 78 75 16 46 16 16 45 16 75 16 16 72 74
16 16 74 16 102 74 75 16 77 16 49 16 16 102 16 16 46 16 16 16 16 16 47 16 72 16 104 226 227 189 189 189 78 44 16 104 477 505 477 16 72 102 74 16 507 419 449 78 103 16 16 16 44 16 103 16 16 44 48 102
77 16 16 72 16 16 16 46 77 46 16 16 16 49 16 46 75 75 16 16 102 16 75 47 16 16 16 16 189 189 189 189 78 48 16 104 420 448 448 446 45 79 72 75 476 475 504 78 16 16 16 102 79 48 16 16 16 16 75 75
16 16 16 16 72 16 79 44 103 72 16 44 16 79 16 16 16 79 16 16 79 16 77 47 16 77 16 104 189 189 189 189 78 16 46 16 104 447 505 418 477 478 16 447 475 477 505 78 16 16 16 16 16 16 16 79 16 16 16 46
47 79 103 16 16 16 16 16 77 16 16 75 16 16 16 16 16 16 16 16 102 16 16 16 44 16 16 75 189 189 189 16 16 16 16 72 75 104 507 419 448 446 446 475 447 478 78 103 16 46 102 16 45 16 16 16 16 16 16 16
16 48 16 16 16 16 16 72 16 102 16 16 16 16 2 145 145 16 103 16 45 79 74 45 16 72 104 189 189 199 189 78 46 16 44 77 16 104 477 505 475 505 446 475 76 76 16 16 16 16 16 46 16 16 16 16 77 16 16 16
46 16 16 16 16 16 16 16 16 77 16 48 2 145 145 145 145 153 154 145 145 77 158 16 16 158 158 189 189 189 199 78 102 47 47 16 16 16 76 417 420 448 505 76 16 16 77 74 16 72 16 16 79 103 16 16 16 16 16 46
16 16 16 16 16 16 16 102 45 16 16 145 145 145 145 145 145 183 2 145 145 154 189 16 16 16 189 189 189 189 189 189 189 189 189 198 198 16 16 76 76 76 76 16 16 16 16 46 16 16 103 48 16 74 16 16 16 16 16 72
16 16 16 48 16 16 49 16 46 16 145 182 2 145 145 145 2 145 145 145 145 189 189 16 46 16 189 189 189 189 199 226 189 197 227 189 189 189 189 75 72 44 45 102 16 16 16 75 16 77 77 16 16 16 44 102 72 16 16 44
16 16 16 16 16 47 45 77 46 75 145 145 145 2 145 145 153 145 145 154 145 197 154 16 102 102 48 189 189 189 189 189 189 227 189 189 198 189 189 189 198 189 16 75 48 49 16 16 45 16 16 102 45 16 16 16 16 47 16 16
16 16 77 16 16 16 16 16 75 103 145 182 145 145 145 145 183 154 145 145 182 76 76 76 16 16 76 76 76 76 76 76 76 76 76 16 227 226 189 189 189 189 189 189 103 16 49 16 16 16 16 103 16 16 16 16 16 47 16 16
16 16 16 75 74 16 16 74 16 16 16 182 145 145 145 145 145 145 145 182 46 102 77 16 16 47 77 16 16 48 77 16 16 77 16 16 16 16 77 227 16 16 16 16 16 16 103 16 16 16 16 16 49 47 16 16 16 16 75 16
49 16 45 16 16 16 16 103 16 16 16 182 182 182 145 145 145 145 145 16 72 16 16 16 72 16 16 44 103 16 16 16 47 45 16 72 46 16 16 48 16 16 16 77 16 16 47 48 49 16 49 44 16 16 16 103 48 47 45 49
16 102 16 77 102 16 16 16 16 16 16 79 145 145 145 145 182 145 16 16 102 16 16 45 47 75 74 16 16 16 16 45 74 16 74 16 16 16 75 16 44 45 46 47 16 16 16 16 49 72 16 16 47 16 16 45 16 46 16 46
16 16 103 75 16 16 16 16 47 48 16 16 79 145 145 145 102 47 75 16 16 46 16 45 16 16 16 16 16 46 77 16 79 16 16 48 74 16 49 44 16 16 44 16 79 77 48 49 16 16 16 79 74 16 16 47 16 47 74 46
74 16 16 102 16 48 16 16 16 77 16 16 16 75 16 48 79 16 102 16 48 16 16 16 79 45 44 16 16 72 16 16 16 16 48 45 16 102 48 16 77 45 16 16 16 16 48 77 16 16 16 16 16 45 16 47 49 72 16 16
16 48 16 16 75 46 16 74 16 16 48 16 16 16 49 16 16 16 16 16 72 102 16 102 74 16 74 16 16 49 16 16 16 16 16 16 79 79 48 16 72 72 16 103 16 16 103 49 16 16 16 16 46 16 16 102 45 16 16 16
77 16 45 16 77 16 16 16 16 77 46 46 16 16 77 16 102 16 47 16 103 102 16 72 48 16 49 16 16 16 16 16 46 16 46 44 49 16 16 16 16 77 44 16 16 16 16 75 46 16 16 74 102 45 16 16 16 103 16 79
16 16 16 16 16 16 103 75 47 16 16 16 16 74 47 16 16 16 48 16 16 47 45 16 16 16 75 16 16 48 77 72 16 16 16 102 16 16 16 49 16 16 16 16 74 72 46 77 16 16 16 16 16 16 49 48 16 16 16 16
102 16 16 16 16 16 16 16 16 16 16 16 16 16 16 16 16 16 44 16 16 16 79 102 72 16 103 49 16 16 79 16 16 102 46 16 16 16 16 74 16 49 44 46 16 16 16 75 16 16 16 16 79 16 16 79 47 16 16 16
79 16 74 16 47 16 16 79 75 16 102 16 49 77 16 16 103 48 74 16 16 49 45 72 45 16 79 16 16 16 16 16 75 16 16 16 16 77 16 48 102 16 46 44 16 16 16 16 47 16 16 49 16 16 45 102 79 16 16 16
74 16 16 72 16 103 16 16 48 16 16 16 16 44 16 16 103 16 16 16 75 16 103 103 16 16 16 16 16 16 72 16 102 102 16 16 74 48 77 16 48 16 16 46 16 16 16 44 16 16 16 16 103 16 16 16 16 48 44 75
16 16 75 16 16 48 45 72 16 16 16 72 45 16 16 49 103 16 74 44 16 16 102 16 16 47 16 48 16 16 77 16 102 16 74 16 16 74 16 47 49 74 16 46 16 16 72 16 16 16 75 16 45 16 103 47 16 16 46 16
16 16 79 16 47 48 16 16 16 49 16 16 16 16 72 16 46 16 79 16 16 16 47 16 16 16 46 16 16 16 49 77 74 16 77 16 79 16 102 16 77 72 45 46 16 16 75 16 16 16 16 16 16 75 16 47 16 16 74 16