239 240 239 240 239 240 295 296 297 298 299 300 295 296 297 298 299 300 295 296 297 298 299 300 239 240 1 1 1 1 1 1 1 1 1 1 1 1 1 1 1 1 1 1 1 1 1 1 1 1 1 1 1 1 1 1 1 1 1 1
268 269 268 269 268 269 324 325 326 327 328 329 324 325 326 327 328 329 324 325 326 327 328 329 268 269 1 1 1 1 1 1 1 1 1 1 156 1 1 1 1 1 1 157 1 1 1 1 1 1 1 1 1 1 1 1 1 1 1 1
297 298 297 298 297 298 295 296 297 298 299 300 295 296 297 298 299 300 295 296 297 298 299 300 297 298 1 1 1 1 1 1 156 1 1 1 1 1 1 1 1 1 1 1 1 1 1 157 1 1 1 1 1 1 1 1 1 1 1 1
326 327 326 327 326 327 324 325 326 327 328 329 324 325 326 327 328 329 324 325 326 327 328 329 326 327 1 1 1 156 1 1 1 1 1 1 1 1 1 1 1 1 1 1 1 1 1 1 1 157 1 1 1 1 1 1 1 1 1 1
355 356 355 356 355 356 297 298 295 296 297 298 299 300 295 296 297 298 299 300 297 298 299 300 355 356 1 1 1 1 1 1 1 1 1 1 1 1 1 1 1 1 1 1 1 1 1 1 1 1 1 157 1 1 1 1 1 1 1 1
384 385 384 385 384 385 326 327 324 325 326 327 328 329 324 325 326 327 328 329 326 327 328 329 384 385 1 1 156 1 1 1 1 1 1 1 1 1 1 1 1 1 1 1 1 1 1 1 1 1 1 1 157 1 1 1 239 240 239 240
239 240 297 298 297 298 205 206 297 298 205 206 297 298 297 298 297 298 297 298 297 298 299 300 239 240 1 1 1 1 1 1 1 1 1 1 1 1 1 1 1 1 1 1 1 1 1 1 1 1 1 1 1 157 1 1 268 269 268 269
268 269 326 327 326 327 234 235 326 327 234 235 326 327 326 327 326 327 326 327 326 327 328 329 268 269 1 156 1 1 1 1 1 1 1 1 1 1 1 1 1 1 1 1 1 1 1 1 1 1 1 1 1 1 157 1 297 298 297 298
297 298 297 298 297 298 297 298 297 298 357 412 413 412 413 412 413 412 413 412 297 298 239 240 297 298 1 1 1 1 1 1 1 1 1 1 1 1 1 1 1 1 1 1 1 1 1 1 1 1 1 1 1 1 1 1 326 327 326 327
326 327 326 327 326 205 206 327 326 327 330 441 442 441 442 441 442 441 442 265 326 327 268 269 326 327 1 1 1 1 1 1 1 1 1 1 1 1 1 1 1 1 1 1 1 1 1 1 1 1 1 1 1 1 1 1 355 356 355 356
355 356 297 298 297 234 235 298 415 412 359 315 316 1 1 1 1 1 1 294 205 206 297 298 355 356 1 1 1 1 1 1 1 1 1 1 1 1 1 184 1 1 159 1 1 1 1 1 1 1 1 1 1 1 1 265 384 385 384 385
384 385 326 327 326 327 326 327 272 441 442 1 1 190 1 191 1 314 1 323 234 235 326 327 384 385 272 1 1 1 1 1 1 1 1 1 1 184 1 318 1 1 318 1 159 1 1 1 1 1 1 1 1 1 1 294 239 240 239 240
239 240 239 240 239 240 205 206 301 1 261 262 1 1 1 1 1 1 1 352 413 352 297 298 239 240 301 1 1 1 1 1 1 1 1 1 1 1 315 190 1 1 191 1 1 1 1 1 1 1 1 1 1 1 1 323 268 269 268 269
268 269 268 269 268 269 234 235 330 1 290 291 1 1 1 1 1 1 1 381 442 323 326 327 268 269 330 159 1 1 1 1 1 1 1 1 1 314 1 1 1 1 1 317 44 1 1 1 1 1 1 1 1 1 184 352 297 298 297 298
297 298 205 206 297 298 297 298 359 1 246 1 1 193 1 1 1 1 318 1 1 352 205 206 297 298 359 1 1 1 1 1 1 1 1 1 1 1 1 1 1 1 1 1 156 1 1 1 1 1 1 1 1 1 1 209 326 327 326 327
326 327 234 235 326 327 326 327 272 1 1 1 1 1 1 218 1 1 1 265 266 323 234 235 326 297 272 1 1 1 1 1 1 1 1 1 1 157 315 193 1 1 218 1 1 1 1 1 1 1 1 1 1 1 209 268 355 356 355 356
355 356 355 356 355 356 205 206 301 1 1 1 1 1 1 1 346 1 1 294 295 326 327 326 327 326 327 272 159 1 1 1 1 1 1 1 1 1 157 1 1 1 1 156 1 1 1 1 1 1 1 1 1 1 238 239 240 239 240 239
384 385 384 385 384 385 234 235 272 271 272 1 1 190 1 191 1 281 1 265 326 205 206 297 298 297 298 301 1 1 1 1 1 1 1 1 1 1 1 1 1 1 1 1 1 1 1 1 1 1 1 1 1 184 265 268 269 268 269 268
239 240 239 240 239 240 297 298 297 298 301 1 1 1 1 1 1 1 1 294 297 234 235 326 205 206 327 330 1 159 1 1 1 1 1 1 1 1 1 1 1 1 316 1 1 1 1 1 1 1 1 1 1 1 294 297 298 297 298 297
268 269 268 269 268 269 326 327 326 327 272 1 1 193 1 1 1 265 330 265 326 327 324 325 234 235 328 329 330 1 159 1 1 1 1 1 1 1 1 1 1 1 1 1 1 1 1 1 1 1 1 1 184 1 265 326 327 326 327 326
297 298 297 298 297 298 355 356 205 206 301 1 1 1 1 1 1 294 297 298 205 206 297 298 295 296 297 298 299 272 1 159 1 1 1 1 1 1 1 314 1 1 1 1 1 1 1 1 1 1 1 184 1 1 294 355 356 355 356 355
326 327 326 327 326 327 268 269 234 235 330 1 317 1 1 1 1 323 326 327 234 235 326 327 324 325 326 327 328 329 272 209 210 159 1 1 1 1 1 1 1 1 1 1 1 1 1 1 1 1 184 1 209 210 211 384 385 384 385 384
355 356 355 356 355 356 297 298 297 298 359 1 1 190 1 1 1 412 297 298 297 298 205 206 295 296 205 206 299 300 297 298 241 1 1 159 1 1 184 1 1 1 1 159 1 1 1 184 1 1 1 1 294 295 296 297 298 299 300 239
384 385 384 385 384 385 326 327 326 359 1 1 1 1 1 1 1 1 352 327 326 327 234 235 324 325 234 235 328 329 326 327 270 209 210 1 1 1 1 190 1 1 1 1 265 266 265 266 209 210 211 212 265 324 325 326 327 328 329 268
239 240 239 240 239 240 297 298 413 388 1 1 1 1 1 1 1 1 381 412 297 298 297 298 295 296 297 298 299 300 359 358 329 326 385 386 372 1 1 1 1 1 191 1 294 205 206 295 296 205 206 299 300 295 296 297 298 299 300 297
268 269 268 269 268 269 326 327 272 1 377 378 1 1 1 1 1 318 1 323 326 415 412 413 414 415 414 415 412 329 272 387 358 359 414 415 1 372 1 1 1 1 1 1 265 234 235 324 325 234 235 328 329 324 325 326 327 328 329 326
297 298 297 298 297 298 205 206 301 1 406 407 1 1 1 1 1 1 1 352 413 444 441 442 261 262 443 444 441 358 359 1 1 1 443 444 1 1 1 1 1 1 1 191 352 353 352 353 352 353 412 413 414 415 412 413 358 239 240 355
326 327 326 327 326 327 234 235 330 1 1 1 1 193 1 1 191 1 1 381 442 443 1 217 290 291 246 1 340 387 388 1 190 1 1 191 1 1 190 1 1 1 1 1 381 382 381 382 381 382 441 442 443 343 441 442 265 268 269 384
355 356 355 356 355 356 297 298 359 1 1 1 1 1 1 1 1 1 1 1 191 1 1 1 284 1 1 1 1 190 1 1 1 1 1 1 1 1 1 1 1 1 1 1 1 1 1 1 1 191 1 1 1 1 1 1 294 297 298 297
384 385 384 385 384 385 326 327 272 209 210 211 212 1 193 1 1 1 1 1 1 1 1 1 1 1 1 1 1 1 1 1 1 1 1 1 1 1 1 1 1 1 1 1 1 1 1 1 1 1 1 1 1 1 314 1 323 326 327 326
239 240 239 240 297 298 299 300 297 298 297 298 301 1 1 1 1 1 193 1 1 1 1 1 1 1 1 1 1 1 1 1 1 1 1 1 1 1 218 1 1 193 1 1 1 1 1 1 1 1 1 1 218 1 258 1 352 205 206 355
268 269 268 269 326 327 328 329 326 327 326 327 330 209 210 211 212 271 272 1 193 343 1 1 1 1 1 1 1 1 1 1 1 1 1 1 282 1 1 1 1 1 1 1 1 1 344 1 1 1 316 1 1 281 346 1 265 234 235 384
297 298 297 298 205 206 297 298 205 206 297 298 297 298 297 298 297 298 301 1 1 1 292 1 1 1 1 1 1 1 1 1 304 1 1 1 1 1 1 1 1 1 1 1 1 1 1 1 1 1 1 1 282 316 209 212 294 297 298 301
326 327 326 327 234 235 326 327 234 235 326 327 326 205 206 327 326 327 330 209 210 211 212 209 210 1 254 1 1 1 1 1 319 320 275 1 1 1 1 1 1 1 1 1 1 1 1 209 210 211 212 1 1 1 238 239 266 238 241 1
355 356 355 356 295 296 297 298 299 300 297 298 297 234 235 298 297 298 297 298 297 298 205 206 297 272 1 190 1 1 1 1 348 349 304 1 1 1 1 1 1 1 1 1 1 1 1 238 297 298 241 1 1 1 209 268 269 210 211 272
384 385 384 385 324 325 326 327 328 329 326 327 326 327 326 327 326 327 326 327 326 327 234 235 326 301 1 1 1 1 1 1 1 1 1 1 1 1 1 1 1 1 1 1 1 1 1 265 326 327 270 209 210 211 296 297 298 297 298 241
297 298 299 300 295 296 297 298 205 206 297 298 301 412 413 414 415 294 297 298 205 206 297 298 297 330 1 1 1 1 1 191 1 1 1 1 1 1 1 1 315 314 1 1 1 1 1 294 297 298 297 298 297 298 205 206 327 326 327 272
326 327 328 329 324 325 326 327 234 235 326 327 330 441 442 443 444 323 326 327 234 235 326 205 206 359 1 1 1 1 1 1 286 203 204 288 1 1 1 1 316 314 314 1 1 1 1 323 326 205 206 327 326 327 234 235 356 355 356 327
295 296 297 298 299 300 205 206 415 412 413 414 415 1 1 372 1 412 413 414 415 352 297 234 235 330 259 193 1 1 1 1 1 232 233 1 1 1 1 1 1 315 316 1 1 1 1 352 297 234 235 298 205 206 297 384 385 298 297 298
324 325 326 327 328 329 234 235 386 372 442 443 444 1 1 1 407 441 442 443 444 265 326 327 268 359 1 1 1 1 1 1 1 1 285 1 1 1 1 1 1 1 1 1 1 1 1 265 326 327 326 327 234 235 326 327 326 327 326 327
295 296 297 298 299 300 353 414 415 1 1 1 1 1 1 1 1 1 1 1 1 412 413 414 353 388 1 190 1 1 1 218 1 287 1 1 1 1 1 1 1 1 1 1 1 1 1 294 297 298 297 298 297 298 297 298 297 298 297 298
324 325 326 327 328 329 272 372 444 1 1 148 148 146 1 1 1 147 148 148 148 441 442 443 444 255 1 1 1 1 1 1 1 1 1 1 292 1 1 1 1 1 1 1 1 1 1 323 326 327 326 327 326 327 326 327 326 327 326 327
295 296 297 298 299 300 301 1 1 1 1 146 1 1 1 1 1 1 1 1 1 147 1 1 1 1 190 1 1 1 1 191 1 1 1 1 1 1 1 1 1 1 1 1 345 1 1 352 295 296 205 206 299 300 295 296 297 298 299 300
324 325 326 205 206 329 330 1 1 1 146 1 1 1 1 1 1 1 1 1 1 1 1 1 1 1 1 1 1 1 1 1 1 1 1 1 1 191 1 1 1 1 1 1 1 372 1 265 324 325 234 235 328 329 324 325 326 327 328 329
295 296 297 234 235 300 359 1 1 1 1 1 1 346 1 1 345 1 1 1 1 1 1 1 1 1 1 1 1 1 1 1 1 1 1 1 1 346 1 191 1 1 1 1 1 316 1 294 295 296 205 206 299 300 295 296 297 298 299 300
324 325 326 327 328 329 272 1 377 1 1 1 1 1 1 1 1 1 1 1 1 1 1 1 1 1 1 1 1 1 1 1 1 1 1 1 1 1 1 1 1 1 191 1 1 1 1 1 352 325 234 235 328 205 206 325 326 327 328 329
295 296 297 298 299 300 301 1 1 1 1 1 344 1 1 1 1 344 1 1 1 174 1 1 1 1 1 1 1 1 1 1 1 1 1 193 1 1 1 1 1 1 346 1 1 1 315 311 381 412 239 240 239 234 235 240 239 240 239 240
324 325 326 327 328 329 330 1 1 1 149 1 1 1 1 1 1 1 1 1 174 1 1 283 1 1 1 209 210 211 212 211 212 1 258 312 1 1 193 346 218 1 1 1 1 1 1 282 340 265 268 269 268 269 268 269 268 269 268 269
295 296 297 298 205 206 359 1 1 1 1 1 1 1 345 1 1 1 1 174 1 1 1 1 1 1 1 294 295 296 297 298 301 1 1 288 1 1 1 1 1 1 314 1 1 261 262 1 1 294 297 298 297 298 239 240 297 298 297 298
324 325 326 327 234 235 272 1 407 1 1 149 1 1 1 1 1 1 174 1 1 372 1 209 210 211 212 209 324 205 206 327 330 209 210 211 212 209 212 1 1 342 1 1 1 290 291 246 1 323 326 205 206 327 268 205 206 327 326 327
295 296 205 206 299 300 301 1 1 1 1 1 149 1 1 1 174 1 1 1 1 1 1 294 299 300 295 296 297 234 235 300 205 206 205 206 299 300 241 1 1 1 1 1 1 1 1 1 1 352 355 234 235 356 297 234 235 356 355 356
324 325 234 235 328 329 330 271 272 1 1 407 1 30 31 32 1 1 1 1 1 1 1 265 328 329 324 205 206 327 328 329 234 235 234 235 328 329 210 211 210 211 212 209 210 211 212 209 210 265 384 385 384 385 326 327 384 385 384 385
295 296 297 298 299 300 297 300 301 1 1 406 1 1 1 1 377 1 1 1 1 1 1 294 299 300 295 234 235 298 299 300 295 296 297 298 299 300 239 240 239 240 205 206 297 298 299 300 295 296 297 298 299 300 355 356 239 240 239 240
324 325 326 327 328 329 326 327 272 271 272 1 1 1 1 209 210 211 212 377 1 265 266 323 328 329 324 325 326 327 328 205 206 325 326 205 206 329 268 205 206 269 234 235 326 205 206 329 324 325 326 327 328 329 384 385 268 269 268 269
295 296 297 298 299 300 205 206 297 298 301 1 1 1 1 238 205 206 241 1 406 294 297 298 205 206 295 296 205 206 299 234 235 296 297 234 235 300 297 234 235 298 239 240 295 234 235 298 299 300 205 206 297 298 299 300 297 298 297 298
324 325 326 327 328 329 234 235 326 327 330 209 210 211 212 209 234 235 212 209 210 211 326 327 234 235 324 325 234 235 328 329 324 325 326 327 328 329 326 327 326 327 268 269 324 325 326 327 328 329 234 235 326 327 328 329 326 327 326 327
295 296 297 298 299 300 295 296 297 298 205 206 295 296 297 298 205 206 295 296 297 298 299 300 295 296 297 298 299 300 295 296 205 206 299 300 295 296 355 356 355 356 297 298 297 298 295 296 297 298 299 300 295 296 297 298 299 300 355 356
324 325 326 327 328 329 324 325 326 327 234 235 324 325 326 327 234 235 324 325 326 327 328 329 324 325 326 327 328 329 324 325 234 235 328 329 324 325 384 385 384 385 326 327 326 327 324 325 326 327 328 329 324 325 326 327 328 329 384 385
295 296 297 298 299 300 295 296 297 298 299 300 295 296 297 298 299 300 295 296 297 298 299 300 295 296 297 298 299 300 295 296 297 298 299 300 295 296 297 298 299 300 355 356 355 356 295 296 297 298 299 300 295 296 297 298 299 300 295 296
324 325 326 327 328 329 324 325 326 327 328 329 324 325 326 327 328 329 324 325 326 327 328 329 324 325 326 327 328 329 324 325 326 327 328 329 324 325 326 327 328 329 384 385 384 385 324 325 326 327 328 329 324 325 326 327 328 329 324 325