4 4 4 4 4 4 4 4 4 4 4 4 4 4 4 5 2 2 2 9 3 3 3 9 10 10 10 10 10 10 10 10 10 10 10 10 10 10 10 10 10 10 10 10 10 10 10 10 10 10
4 4 4 4 4 4 4 4 4 4 4 4 4 4 4 5 2 2 2 9 3 3 3 9 10 10 10 10 10 10 10 10 10 10 10 10 10 10 10 10 10 10 10 10 10 10 10 10 10 10
4 4 0 0 0 0 0 0 0 0 0 0 0 4 4 5 2 2 2 9 3 3 3 9 10 10 10 10 10 10 10 10 10 10 10 10 10 10 10 10 10 10 10 10 10 10 10 10 10 10
4 4 0 0 0 0 0 0 0 0 0 0 0 4 4 5 7 7 7 3 3 3 3 3 8 8 8 8 8 8 8 8 8 8 8 8 8 8 8 8 8 8 8 8 8 8 8 10 10 10
4 4 0 0 0 0 0 0 0 0 0 0 0 4 4 5 6 6 6 3 3 3 3 3 8 8 8 8 8 8 2 2 2 2 2 2 2 2 2 2 2 2 2 2 8 8 8 10 10 10
4 4 0 0 0 0 0 0 0 0 0 0 0 4 4 5 7 7 7 3 3 3 3 3 8 8 8 8 8 8 2 2 2 2 2 2 2 2 2 2 2 2 2 2 8 8 8 10 10 10
4 4 0 0 0 0 0 0 0 0 0 0 0 4 4 5 2 2 2 9 3 3 3 9 10 10 10 8 8 8 2 2 2 2 2 2 2 2 2 2 2 2 2 2 8 8 8 10 10 10
4 4 0 0 0 0 0 0 0 0 0 0 0 4 4 5 2 2 2 9 3 3 3 9 10 10 10 8 8 8 2 2 2 2 2 2 2 2 2 2 2 2 2 2 8 8 8 10 10 10
4 4 4 4 4 4 4 4 4 4 4 4 4 4 4 5 2 2 2 9 3 3 3 9 10 10 10 8 8 8 2 2 2 2 2 2 2 2 2 2 2 2 2 2 8 8 8 10 10 10
4 4 4 4 4 4 4 4 4 4 4 4 4 4 4 5 2 2 2 9 3 3 3 9 10 10 10 8 8 8 2 2 2 2 2 2 2 2 2 2 2 2 2 2 8 8 8 10 10 10
5 5 5 5 5 5 5 5 5 5 5 5 5 5 5 5 2 2 2 9 3 3 3 9 10 10 10 8 8 8 8 8 8 8 8 8 8 8 8 8 8 8 8 8 8 8 8 10 10 10
2 2 2 2 2 2 7 6 6 7 2 2 2 2 2 2 2 2 2 9 3 3 3 9 10 10 10 8 8 8 8 8 8 8 8 8 8 8 8 8 8 8 8 8 8 8 8 10 10 10
2 2 2 2 2 2 7 6 6 7 2 2 2 2 2 2 2 2 2 9 3 3 3 9 10 10 10 10 10 10 10 10 10 10 10 10 10 10 10 10 10 10 10 10 10 10 10 10 10 10
2 2 2 2 2 2 7 6 6 7 2 2 2 2 2 2 2 2 2 9 3 3 3 9 10 10 10 10 10 10 10 10 10 10 10 10 10 10 10 10 10 10 10 10 10 10 10 10 10 10
9 9 9 9 9 9 3 3 3 3 9 9 9 9 9 9 9 9 9 9 3 3 3 9 9 9 9 9 9 9 9 9 9 9 9 9 9 9 9 9 9 9 9 9 9 9 9 9 9 9
3 3 3 3 3 3 3 3 3 3 3 3 3 3 3 3 3 3 3 3 3 3 3 3 3 3 3 3 3 3 3 3 3 3 3 3 3 3 3 3 3 3 3 3 3 3 3 3 3 3
9 9 9 9 9 9 3 3 3 3 9 9 9 9 9 9 9 9 9 9 3 3 3 9 9 9 9 9 9 9 9 9 9 9 9 9 9 9 9 11 11 11 9 9 9 9 9 9 9 9
5 5 5 5 5 5 5 5 5 5 5 5 5 5 5 5 5 5 5 9 3 3 3 9 11 11 11 11 11 11 11 11 11 11 11 11 11 11 11 11 11 11 11 11 11 11 11 11 11 11
5 16 16 16 16 5 5 5 5 5 5 16 16 16 16 16 16 5 5 9 3 3 3 9 11 12 11 12 11 11 11 12 11 12 11 12 11 12 11 12 11 12 11 12 11 12 11 12 11 12
5 16 16 16 16 5 5 5 5 5 5 16 16 16 16 16 16 5 5 9 3 3 3 9 11 11 12 11 12 11 12 11 12 11 12 11 12 11 12 11 12 11 12 11 12 11 12 11 12 11
5 16 16 16 16 5 5 5 5 5 5 16 16 16 16 16 16 5 5 9 3 3 3 9 11 12 11 11 11 11 11 11 11 11 11 11 11 11 11 11 11 11 11 11 11 11 11 12 11 12
5 16 16 16 16 5 5 5 5 5 5 16 16 16 16 16 16 5 5 9 3 3 3 9 11 11 12 11 11 11 11 11 11 11 11 11 11 11 11 11 11 11 11 11 11 11 11 11 12 11
5 16 16 16 16 5 5 5 5 5 5 16 16 16 16 16 16 5 5 9 3 3 3 9 11 12 11 11 11 11 11 11 11 11 11 11 11 11 11 11 11 11 11 11 11 11 11 12 11 12
5 16 16 16 16 5 5 5 5 5 5 16 16 16 16 16 16 5 5 9 3 3 3 9 11 11 12 11 11 11 11 11 11 11 11 11 11 11 11 11 11 11 11 11 11 11 11 11 12 11
5 5 5 5 5 5 5 5 5 5 5 5 5 5 5 5 5 5 5 9 3 3 3 9 11 12 11 12 11 12 11 12 11 12 11 12 11 12 11 12 11 12 11 12 11 12 11 12 11 12
5 5 5 5 5 5 5 5 5 5 5 5 5 5 5 5 5 5 5 9 3 3 3 9 11 11 12 11 12 11 12 11 12 11 12 11 12 11 12 11 12 11 12 11 12 11 12 11 12 11
5 16 16 16 16 5 5 5 5 5 5 16 16 16 16 16 16 5 5 9 3 3 3 9 11 12 11 12 11 11 11 11 11 11 11 11 11 11 11 11 11 11 11 11 11 11 11 12 11 12
5 16 16 16 16 5 5 5 5 5 5 16 16 16 16 16 16 5 5 9 3 3 3 9 11 11 12 11 11 11 11 11 11 11 11 11 11 11 11 11 11 11 11 11 11 11 11 11 12 11
5 16 16 16 16 5 5 5 5 5 5 16 16 16 16 16 16 5 5 9 3 3 3 9 11 12 11 11 11 11 11 11 11 11 11 11 11 11 11 11 11 11 11 11 11 11 11 12 11 12
5 16 16 16 16 5 5 5 5 5 5 16 16 16 16 16 16 5 5 9 3 3 3 9 11 11 12 11 11 11 11 11 11 11 11 11 11 11 11 11 11 11 11 11 11 11 11 11 12 11
5 16 16 16 16 5 5 5 5 5 5 16 16 16 16 16 16 5 5 9 3 3 3 9 11 12 11 12 11 12 11 12 11 12 11 12 11 12 11 12 11 12 11 12 11 12 11 12 11 12
5 16 16 16 16 5 5 5 5 5 5 16 16 16 16 16 16 5 5 9 3 3 3 9 11 11 12 11 12 11 12 11 12 11 12 11 12 11 12 11 12 11 12 11 12 11 12 11 12 11
5 5 5 5 5 5 5 5 5 5 5 5 5 5 5 5 5 5 5 9 3 3 3 9 11 11 11 11 11 11 11 11 11 11 11 11 11 11 11 11 11 11 11 11 11 11 11 11 11 11
2 2 2 2 2 2 2 2 2 2 2 2 2 2 2 2 2 2 2 7 6 6 6 7 2 2 2 2 2 2 2 2 2 2 2 2 2 2 2 2 2 2 2 2 2 2 2 2 2 2
2 2 2 2 2 2 2 2 2 2 2 2 2 2 2 2 2 2 2 7 6 6 6 7 2 2 2 2 2 2 2 2 2 2 2 2 2 2 2 2 2 2 2 2 2 2 2 2 2 2
2 2 2 2 2 2 2 2 2 2 2 2 2 2 2 2 2 2 2 7 6 6 6 7 2 2 2 2 2 2 2 2 2 2 2 2 2 2 2 2 2 2 2 2 2 2 2 2 2 2
15 15 15 15 15 15 15 15 15 15 15 15 15 15 15 15 15 15 15 9 3 3 3 9 5 5 5 5 5 5 5 5 5 5 5 5 5 5 5 5 5 5 5 5 5 5 5 5 5 5
15 4 4 4 4 4 4 4 4 4 4 4 4 4 4 4 4 4 15 9 3 3 3 9 5 5 5 5 5 5 5 5 5 5 5 5 5 5 5 5 5 5 5 5 5 5 5 5 5 5
15 4 14 4 14 3 3 3 3 3 3 3 3 3 3 3 3 4 15 9 3 3 3 9 5 5 5 5 5 5 5 5 5 5 5 5 5 5 2 2 2 2 2 2 2 2 2 2 2 2
15 4 14 4 14 3 2 2 2 2 2 2 2 2 2 2 3 4 15 9 3 3 3 9 5 5 5 5 2 2 2 2 2 2 2 2 2 2 2 2 2 2 2 2 2 2 2 2 2 2
15 4 14 4 14 3 2 2 2 2 2 2 2 2 2 2 3 4 15 9 3 3 3 9 5 5 5 5 2 2 2 2 2 2 2 2 2 2 2 2 2 2 2 2 2 2 2 2 2 2
15 4 14 4 14 3 2 2 2 2 2 2 2 2 2 2 3 3 3 3 3 3 3 3 5 5 5 5 2 2 2 2 2 2 2 2 2 2 2 2 2 2 2 2 2 2 2 2 2 2
15 4 14 4 14 3 2 2 2 2 2 2 2 2 2 2 3 3 3 3 3 3 3 3 5 5 5 5 2 2 2 2 2 2 2 2 2 2 2 2 2 2 2 2 2 2 2 2 2 2
15 4 14 4 14 3 2 2 2 2 2 2 2 2 2 2 3 4 15 9 3 3 3 9 5 5 5 5 2 2 2 2 2 2 2 2 2 2 2 2 2 2 2 2 2 2 2 2 2 2
15 4 14 4 14 3 2 2 2 2 2 2 2 2 2 2 3 4 15 9 3 3 3 9 5 5 5 5 2 2 2 2 2 2 2 2 2 2 2 2 2 2 2 2 2 2 2 2 2 2
15 4 14 4 14 3 2 2 2 2 2 2 2 2 2 2 3 4 15 9 3 3 3 9 5 5 5 5 2 2 2 2 2 2 2 2 2 2 2 2 2 2 2 2 2 2 2 2 2 2
15 4 14 4 14 3 3 3 3 3 3 3 3 3 3 3 3 4 15 9 3 3 3 9 5 5 5 5 5 5 5 5 5 5 5 5 5 2 2 2 2 2 2 2 2 2 2 2 2 2 2 2
15 4 13 4 13 4 13 4 13 4 13 4 13 4 13 4 13 4 15 9 3 3 3 9 5 5 5 5 5 5 5 5 5 5 5 5 5 5 5 5 5 5 5 5 5 5 2 2 2 2
15 4 13 4 13 4 13 4 13 4 13 4 13 4 13 4 13 4 15 9 3 3 3 9 5 5 5 5 5 5 5 5 5 5 5 5 5 5 5 5 5 5 5 5 5 5 5 5 5 5
15 15 15 15 15 15 15 15 15 15 15 15 15 15 15 15 15 15 15 9 3 3 3 9 5 5 5 5 5 5 5 5 5 5 5 5 5 5 5 5 5 5 5 5 5 5 5 5 5 5